48,64
9999999999999999999999999999999999999999999999999999999999999999
9000000000000000000000000000000000000000000000000000000000000009
9000000000000000333333333333330000000000000000000000000000000009
9000000000000000000000000000000000000000000000000000000000000009
9000000000000000000000000000000000000000000000000000000000000009
9000000000000000000000000000000000000000000000000000000000000009
9000000000000000000000000000000000000000000020000000000000000009
9000222222222222222222000000000000000000000020000000000000000009
9000000000000000000000000000000000000000000020000000000000000009
9000000000000000000000000000000000000000000020000000000000000009
9000000000000000000000000000000000000000000020000000000000000009
9000000000000000000000000000000000000000000020000000000000000009
9000000000000000000000002000000000000000000020000000000000000009
9000000000000000000000002000000000000000000020000000000000000009
9000000000000000000000002000000000000000000020000000000000000009
9000000000000000000000002000000000000000000020000000000000000009
9000000000000000000000002000000000000000000020000000000000000009
9000000000000000000000002000000000000000000020000000000000000009
9000000000000000000000002000000000000000000020000000000000000009
9000000000000000000000002000000000000000000020000000000000000009
9000000000000000000000002000000000000000000020000000000000000009
9000000000000000000000002000000000000000000020000000000000000009
9000000000000000000000002000000000000000000020000000000000000009
9000000000000000000000002000000000000000000020000000000000000009
9000000000000000000000002000000000000000000020000000000000000009
9000000000000000000000002000000000000000000020000000000000000009
9000000000000000000000002000000000000000000020000000000000000009
9000000000000000000000002000000000000000000020000000000000000009
9000000000000000000000002000000000000000000020000000000000000009
9000000000000000000000002000000000000000000020000000000000000009
9000000000000000000000002000000000000000000020000000000000000009
9000000000000000000000002000000000000000000000000000000000000009
9000000000000000000000002000000000000000000000000000000000000009
9000000000000000000000002000000000000000000000000000000000000009
9000000000000000000000002000000000000000000000000000000000000009
9000000000000000000000002000000000000000000000000000000000000009
9000000000000000000000002000000000000000000000000000000000000009
9000000000000000000000002000000000000000000000000000000000000009
9000000000000000000000002000000000000000000000000000000000000009
9000000000000000000000002000000000000000000000000000000000000009
9000000000000000000000000000000000000000000000000000000000000009
9000000000000000000000000000000000000000000000000000000000000009
9000000000000000000000000000000000000000000000000000000000000009
9000000000000000000000000000000000000000000000000000000000000009
9000000000000000000003333333000000300000000000000000000000000009
9000000000000000000000000000000000000000000000000000000000000009
9000000000000000000000000000000000000000000000000000000000000009
9999999999999999999999999999999999999999999999999999999999999999